000000000000000000000000000101000000000000000000000000010
000000000000000100000010000101000010000000000011111111000
001000000000000100100010000000000010001000000000000000000
001000000000000100100010000010000010001000000000000000000
001000000000000100100011100010001110001000000111000000000
001111110000011101110000000111000000000111100100000000000
000000000000000100100011100010001110001000000100000000000
000000000000000100100010000010000010001000000100111111110
000000000000000000100010000000000010001000001000000000000
000001111111100000000010000101000010000000010000000000000
000000000010000000000000000101000000000000111111111110000
001111111010000000000000111101111000000001000000000000000
000100000010011111111000000000000000000010000000000011100
000101111010000000000000000000000000001111111111000000100
000100000010000001110011111000000000000000000000110000100
000100000010000110000000100110000111111111100000001000100
000000000000001000000000100001100000000000000000000000000
000011111111100000000000000000110000000000000111110000000
000000000000100001111111000000000100000000011100000001000
000000000001000010000000110000000010000011100000000000100
000000000001000100000000001000000001111100000000000010010
000000000010001000111100000100000000000000000000110010001
001000000010001001000010000010000111111110000100010010000
001100000010001001001001000001000100000000000010011111001
000100000010001000100100100001000100001000000001000000010
000100000001000100000100100001000100001000000000100000100
000100000001000011111000100001000101111000001110010001000
000111100000100000000001000001000100001000000010000000000
000000000000011000000010000010000100001111111110000000000
000000000000000111111100000010000100000000000000010001000
000000011100000000000000000100000000000000000000100000100
