0000000000000000000000000000000000000000000000000000000000000000
0100000000000000000000000000000000000000000000000000000000000000
0100000000000000000011111111111111111111111111111111111111111110
0100000000011111111100000000000000000000000000000000000000000000
0100000000100000000000011111111111111111111111111111111111111111
0010000001000000000000000000000000000000000000000000000000000000
0001001110000000001000000000000000000000000000000000000000000000
0000100000000000011100000000000000000000000110110110110110000000
0000011000000000111110000000000000011111111100000000000010000000
0000000100000000011100000000000000000000000000101010101000111000
0000000000000000001000000000000000000000000100000000000010000010
0000000000000000000000000000000000000000000100101010101010100010
0000000000000000000000000000000000000000000000000000000000000000
0000000000100000100000000001110000000000000100101010101010101010
0000000000010001000001000010001001000000001100000000000000000010
0000000000001010000001000010001001000010001000101010101010101000
0000000000100100100001000001000001000100001100000000000000000010
0000000000100100100010100000100001001000001110110110110110110110
0000000000100100100011100000010001010000001000000000000000000000
0000000000100000100100010010001001001000001000000000000000000000
0000000000100000100100010010001001000100000000000000000000000000
0000000000100000100100010001110001000010001000000000000000000000
0000000000000000000000000000000000000000000000000000000000000000
0000000000000000000000000000000000000000000000001111111100000100
0000000000000000000000000000000000000000000000000000000000000100
0000000000000000000000000000000000000000000000000000000000001000
0000000000000000000000000001111011110000000000000000000000010000
0000000000000000000000000000001010000000000000000000000000100000
0000000000000000000000000100001010000100000000000111111110000000
0000000000000000000001000100000000000100010000001000000000000000
0000000000000000000001000100000000000100010000001000000000000000
0000000000000000000001000111000000011100010000001000000000000000
0001111111100000000111100000000000000000001111001000000000000000
0000000000000000000001000111000000011100010000001000000000000000
0000000000000000000001000100000000000100010000001000000000000000
0000000000000000000001000100000000000100010000010000000000000000
0000000011111111000000000100001010000100000000100000000000000000
0000000000000000000000000000001010000000000001000000000000000000
0000111111110000000000000001111011110000000010000000000000000000
0000000000000000000000000000000000000000000100000000000000000000
0000000000000000000000000000000000000000001000000000000000000000
0000000000000000000000000000000000000000010000000000000000000000
0000000000000000000000000000000000000000011111111110000000000000
0000000000000000000011111111110000000000000000000001100000000000
0000000000000000001100000000001100000000000000000000010000000000
0000000000000000010000000000000011000000000000000000001000000000
0000000111111111000000000000000001100000000000001000000100000000
0000000000000001000011111110000000001000000000111000000010000000
0000000000000010000100000001100000000100000111000000000001000000
0000000000000010001000000000010000000011111000000000000000100000
0000000000000100010001111000001000000000000000000000000000010000
0000000000000100010010000100000100001111111100001000000000001000
0000000000000100010010010010000010001000000000000100000000010000
0000000000000100010001001001000010001000000000000010000000100000
0000000000000010001000001001000010001000000000000001000001000000
0000000000000010000111110001000010001000000000000000100010000000
0000000000000001000000000010000010001000000000000000000000000000
0000000000000000110000000100000100001000000000000000000000000000
0000000000000000001111111000000100001000000000000000100010000000
0000000000111000000000000000001000000000000000000001000001000000
0000000001000110000000000000010000000000000000000010000000100000
0000000010000000000000000001100000000000000000000100000000010000
0000000010001000000001111110000000000000000000001000000000001000
0000000001000111111110000000000000000000000000000000000000000000
0000000001100000000000000000000000000000000000000000000000000000